6 10
X 0 p 0 P 0 0 0 p 0
1 0 1 0 1 E 1 e 0 0
1 0 1 0 1 0 0 0 1 K
0 0 P 0 p 0 1 0 1 0
0 1 1 K 0 C 1 0 1 0
0 0 0 0 1 0 0 p 0 0