10 6
0 1 1 0 0 0
0 0 X 0 1 0
1 p 1 P 1 0
0 0 0 0 0 0
P 1 1 p K 1
0 E 0 0 C 0
e 1 1 0 1 p
0 0 0 0 0 0
p 1 0 1 1 0
0 0 K 0 0 0