10 6
X 1 1 0 0 0
0 0 0 0 1 0
p 1 1 P 1 0
0 0 0 0 K 0
P 1 1 p 0 1
0 E 0 0 C 0
0 1 0 1 1 0
0 e 0 0 0 p
p 0 1 1 1 0
0 0 K 0 0 0